NO sprites/brick128.xpm
SO sprites/whbrick128.xpm
WE sprites/door128.xpm
EA sprites/interior128.xpm

F 128,0,32
C 135,206,235

1111111111111111111
 111111     111001
11W01111111111111
111111111111111111111111111111111111111111

