NO sprites/brick128.xpm
SO sprites/whbrick128.xpm
C 200,200,200
WE sprites/door128.xpm
EA sprites/interior128.xpm

F 0,100,100


1111111111111111111111
 1000000000111
 1000000000111
 1S00000000111
 1110000000001
 11100000000011111111111111
 1110000000001
11111111111111111
